NO textures/north.xpm
SO textures/south.xpm
WE textures/west.xpm
EA textures/east.xpm

F 184,113,39
C 51,198,227

111111111111
100000000001
100000000001
10000N000001
111111111111
