NO textures/north.xpm
SO textures/south.xpm
WE textures/west.xpm
EA textures/east.xpm

F 184,113,39
C 51,198,227

     1111111
111111000001
100000000001
100110010001
100000000001
10000N000001
100011110001
11111  11111
