NO textures/north.xpm
SO textures/south.xpm
WE textures/west.xpm
EA textures/east.xpm

F 184,113,39
C 51,198,227

11111111111
10000000001
10000100001
10000000001
10000N00001
11111111111